1111111111111
10000E0011111
1P000CCC00011
1001000C00001
1000000000a01
1000000000001
1100001001011
1111111111111