1111111111111111111111111
100010001C001C001C001C001
1010101010101010101010101
1010101010101010101010101
1010101010101010101010101
1010101010101010101010101
1010101010101010101010101
1010101010101010101010101
1P1C0C1C001C001C001C001E1
1111111111111111111111111
1111111111111111111111111